###############################
#......s*.*....*...*.*.*..*...#
#.#.#.#*#.#.#*#*#.#.#.#*#*#*#.#
#..xf.....***..*......*.2.*.*.#
#.#.#.#.#.#*#.#.#*#*#.#.#.#.#*#
#..........x.**..*..*.........#
#.#.#.#.#.#.#.#.#.#*#.#*#.#.#.#
#*..*......*..*......*........#
#.#.#.#.#*#.#.#.#*#*#.#.#.#.#.#
#b....**..*.......*...........#
#.#*#.#.#.#.#.#.#*#.#.#.#.#.#.#
#........1..*...*..*..........#
#.#.#.#.#.#.#.#.#.#.#.#.#.#.#.#
#............................3#
###############################