###############################
#......s*.*....*...*.*.*..*...#
#.#.#.#*#.#.#*#*#.#.#.#*#*#*#.#
#..xf.....***..*......*.1.*.*.#
#.#.#.#.#.#*#.#.#*#*#.#.#.#.#*#
#..........x.**..*..*...1.....#
#.#.#.#.#.#.#.#.#.#*#.#*#.#.#.#
#*..*......*..*......*........#
#.#.#.#.#*#.#.#.#*#*#.#.#.#.#.#
#b....**..*.......*...........#
#.#*#.#.#.#.#.#.#*#.#.#.#.#.#.#
#........1..*...*..*..........#
#.#.#.#.#.#.#.#.#.#.#.#.#.#.#.#
#............................1#
###############################